NO ./textures/Test1.png
SO ./textures/Test2.png
WE ./textures/Test3.png
EA ./textures/Test4.png

F 190,178,123
C 135,206 ,255

111111
1N0001
101111
101  1
     1