NO textures/Test1.png
SO textures/Test1.png
WE textures/Test1.png
EA textures/Test1.png

F 13,13,13
C 242,242,242

11111
10001
10101
10001
1N001
11111